PPPP.PPP
P....PPP
PP..PPSP
PP.PP..P
P..PP.PP
P.PPP..P
P...PP.P
PPP.PP.P
PPP....P
PPPPPPPP
